NO ./textures/diamond.png
SO ./textures/stone.png
WE ./textures/cobble.png
EA ./textures/dirt.png

F 0,144,0
C 5,5,120

111111111111111111111111111111111111111111111111111111111
100000000000000000000000000000000000000000000000000000001
100000000000000000000000000000000000000000000000000000001
100000000000000001111110000000000000000000000000000000001
100000000000000001000010000000000000000000000000000000001
100000000000000001000010000000000000000011100000000000001
100000000000000001111110000000000000000010100000000000001
100000000000000000000000000000000000000011100000000N00001
100000000000000000000000000000000000000000000000000000001
100000000000000000000000000000000000000000000000000000001
100001111100000000000000000000000000000000000000000000001
100001   100000000000000001111000000000000000000000000001
100001   100000000000000001  1000000000000000000000000001
100001111100000000000000001111000000000000000000000000001
100000000000000000000000000000000000000000000000000000001
100000000000000000000000000000000000000000000000000000001
100000000000000000000000000000000000000000000000000000001
100000000000000000000000000000000000000000000000000000001
111111111111111111111111111111111111111111111111111111111